################
#X     @       #
#V             #
#V             #
#G             #
#G             #
#L             #
#L             #
#              #
#              #
#     S        #
#              #
#              #
#         D    #
#              #
################
